# simplex.h keywords

RUN_SIMPLEX	KEYWORD2

SET_NAME	KEYWORD2
VAR_NAME	KEYWORD2
SET_VAR	KEYWORD2

PIN_OUT	KEYWORD2
PIN_COIL	KEYWORD2
PIN_EFFECT	KEYWORD2
PIN_SERVO	KEYWORD2
PIN_INPUT	KEYWORD2
PIN_BUTTON	KEYWORD2
PIN_SENSOR	KEYWORD2

PIN_MODE	KEYWORD2
PIN_TIME	KEYWORD2

SET	KEYWORD2
RESET	KEYWORD2
SERVO	KEYWORD2
ARRIVED	KEYWORD2

ACTIVE	KEYWORD2
FREE	KEYWORD2
PRESSED	KEYWORD2

FSM_NEW	KEYWORD2
FSM_USE	KEYWORD2
FSM_NAME	KEYWORD2
FSM_STATE	KEYWORD2
FSM_GO	KEYWORD2

SET_TIMER	KEYWORD2
TIMEOUT	KEYWORD2

WAIT	KEYWORD2
WAIT_SERVO	KEYWORD2
WAIT_RELEASE	KEYWORD2

FUNCTION	KEYWORD2
CALL	KEYWORD2
REPEAT	KEYWORD2

AND	KEYWORD2
OR	KEYWORD2
NOT	KEYWORD2
EQUAL	KEYWORD2

PIN_DCC	KEYWORD2
DCC_ACC_RED	KEYWORD2
DCC_ACC_GREEN	KEYWORD2

XNET_ADDR	KEYWORD2
XNET_RED	KEYWORD2
XNET_GREEN	KEYWORD2
XNET_TOGGLE	KEYWORD2
XNET_ACTIVE	KEYWORD2
XNET_FREE	KEYWORD2
XNET_CHANGED	KEYWORD2

# simplex.h literals

NORMAL	LITERAL1
INVERT	LITERAL1
FLASH	LITERAL1
DIMMER	LITERAL1
CANDLE	LITERAL1
FIRE	LITERAL1
FLUORESCENT	LITERAL1
WELDING	LITERAL1
PWM	LITERAL1
